#        B
# #######
# #     #
# # ### #
#   #   #
### # ###
#A  #